..#####
..#...#####
.##.......#
##........#
#.......@.#
##........#
.#........#
.#.......##
.#......##
.#.....##
.#######
